1,1,1,1,1,1,1,1,1,1,1,1,1,1,1,1,1,1,1,1
1,0ib,0ib,0ib,0,0,0,0,0,0,0,0,0,0,0,0,0,0,0,1
1,0,0,0,0,0,0,0,0,0,0,0,0,1,1,1,0,0,0,1
1,0,0,1,2,0,0,0,0,0,0,0,0,1,0,1,0,0,0,1
1,0,0,2,1,0,0,0,4,0,0,0,0,1,0,1,0,0,0,1
1,0,0,0,0,0,0,0,0,0,0,0,0,1,1,1,0,0,0,1#
1,0,0,0,0,0,0,0,0,0,0,0,0,0,0,0,0,0,0,1
1,0,0,0ilb,0,0,0l*,0,0,0,0,0,0,0,0,0,0,0,0,1
1,0,0,0,0,0,0,0,0,0,0,0,0,0,0,0,0,0,0,1
1,0,0,0,0,0,0,0,0,0,0,0,0,0,0,0l*,0,0,0,1
1,0,0,0,0,1,1,1,1,0,0,0,0,0,0,0,0,0,0,1#
1,0,0,0,0,1,0,0,1,0,0,0,0,0,0,0,0,0,0,1
1,0,0,0,0,1,0,0,1,1,1,1,0,0,0,0,0,0,0,1
1,0,0,0,0,1,0,0,0,0,0,1,0,0,0,0,0,0,0,1
1,0,0,0,0,1,1,1,1,1,1,1,0,0,0,0,0,0,0,1
1,0,0!,c,0,0,0,0,0,0,0,0,0,0,0,0,0,0,0,1
1,0,0,c,0,0,0,0,0,0,0,0,0,0,0,0,0,0,0,1
1,0,0ip,c,0ip,0,0,0,0,0,0,0,0,0,0,0,0,0,0,1
1,0,3,c,3,0,0,0,0,2,2,2,2,2,0,0,0,0,0,1
1,0,3,c,3,0,0,0,0,2,0,0,0,2,0,0,0,0,0,1$
1,0,3,c,3,3,3,0,0,2,2,2,2,2,0,0,0,0,0,1$$
1,0,3#,c@,c,c,c,c,0,0,0,0,0,0,0,0,0,0,0,1
1,0,3,3#,3,3,3,0,0,0,0,0,0,0,0,0,0,0,0,1
1,0,0,0,0,0,0,0,0,0,0,0,0,0,0,0,0,0,0,1
1,1,1,1,1,1,1,1,6,0,6,1,1,1,1,1,1,1,1,1
1,1;1,1;1,1;1,1;1,1;1,1,1,5,0*l,5,1,1,1;1,1,1,1,1,1,1
1,1;1,1;1;2,1;1;2,1;1;2,1;1,1,1,5,0,5,1,1,1;1;3,1;1,1,1,1,1,1
1,1;1,1;1,1;1,1;1,1;1,5,5,5,0*l,5,5,5,1;1,1;1,1;1,1,1,1,1
5,5,5,5,5,5,5,0ip,0ip,0,0ip,0ip,5,5,5,5,5,5,5,5
5,0!,0!,0!,0!,0!,0!,0!,0!,0!,0!,0!,0!,0!,0!,0!,0!,0!,0!,5
5,0!,g!,g!,g!,g!,g!,g!,g!,g!,g!,g!,g!,g!,g!,g!,g!,g!,0!,5
5,0!,g!,g!,g!,g!,g!,g!,g!,g!,g!,g!,g!,g!,g!,g!,g!,g!,0!,5
5#,0!,g!,g!,g!,g!,g!,g!,g!,g!,g!,g!,g!,g!,g!,g!,g!,g!,0!,5
5;6,0*!,g!,g!,g!,g!,g!,g!,g!,g!,g!,g!,g!,g!,g!,g!,g!,g!,0!,5
5;5;5,0ip;5;5,0!,0!,0!,0!,0!,0!,0!,0!,0!,0!,0!,0!,0!,0!,0!,0!,0!,5
5;5;5,5;5;5,5;5;5,5,5;5,5,5;6;5,5;5;5,5;6;5,5#,5;5,5,5;5,5,5;5,5,5;5,5,5;5,5;5